####################
#..................#
##.................#
##.................#
##.................#
#......###.........#
#......####........#
#.......###........#
#..................#
#..................#
#..................#
#..................#
#..................#
#..................#
####################
