#...................
###########......###
#.........########.#
#..................#
#..................#
#..P...............#
#.................##
#.................##
#.................##
#..................#
#..................#
#..................#
#..................#
#.......############
########............
