P...................
....................
....................
.......########.....
.....###............
...###..............
..##................
..#.................
....................
..........###.......
.......###..........
.....###.....##.....
.....#....####......
........###.........
..............#.....
...........####.....
..........#.........
....................
....................
...................E
