P.........
..........
....#.....
....#..F..
....#.....
..........
........E.
##########
