PX........
..........
..........
..........
..........
..........
........E.
##########
