P.........
..........
........E.
..........
..........
##########
