P......XX.
.......FF.
..........
..........
........E.
##########
